64 32

1111111111111111111111111111111111111111111111111111111111111111
111                                                          111
11                                                            11
1                                                             11
1                                                11           11
1                                                111          11
1                                                111          11
11                                               1111         11
111         b        1e      111e                1111         11
111111111111111111111111111111111111111111111111111111        11
111   111   111   111   111   111   111   111   111111        11
11     1     1     1     1     1     1     1     111111       11
1      1     1     1     1     1     1     1     111111       11
11     1     1     1     1     1     1     1     1111111      11
111   111   111   111   111   111   111   111   11111111e     11
11111111111111111111111111111111111111111111111111111111111   11
111111111                                                    111
1111111                                                      111
11111                                                       1111
111                                                        11111
11                                                        111111
11                                                       1111111
11                                                    e111111111
11                                                   11111111111
1                               e1       e1     e111111111111111
1                     e 1111111111111111111111111111111111111111
1            e 11111111          1111           1111111111111111
1     11111111                    11                 11111111111
11111.............................11...................111111111
1111111111111111111111111111111111111111111111111111111111111111
1111111111111111111111111111111111111111111111111111111111111111
1111111111111111111111111111111111111111111111111111111111111111

1 26 50
12 8 20

9
22 8 3
32 8 3
56 14 3
54 22 3
32 24 3
41 24 3
48 24 3
22 25 3
13 26 3
