128 19

11111111111111111111111111111111111111111111111111111111111111111111111111111111111111111111111111111111111111111111111111111111
111            111             1111                          1      1  1           11111             1    1                   11
11              1                1                                                  111                                       11
1               1                                                                     1                                       11
1                                                                                     1                                       11
1                                                                                                                             11
1                                                                                                                             11
11              e                                                                                                             11
1111111        11111111                                                                                                       11
1111                                                                                                                          11
111                                                                                            1                              11
11                                                                   e                        11                              11
11                                                           e  11111111                    1111                              11
11                                                   e 11111111                           111111                              11
11                                        e 1111111111                                   1111111                             111
11...1                           e 11111111                                 e          111111111   11        b                11
111111111111            e  1111111                                      1111111      11111111111.11111111111111111111..11111..11
11111111111111111111111111......................................................111111111111111111111111111111111111111111111111
11111111111111111111111111111111111111111111111111111111111111111111111111111111111111111111111111111111111111111111111111111111

3 6 50
109 15 20

8
16 7 3
24 16 3
33 15 3
42 14 3
53 13 3
61 12 3
69 11 3
76 15 3